01 01 01 01 01 01 01 01 01 01 01 01 01 01 01 01 01 01 01 01
04 21 00 00 00 00 00 00 00 00 20 21 00 00 00 00 00 00 21 07
04 00 00 00 00 00 00 00 00 00 00 00 00 00 00 00 00 00 00 07
04 00 00 00 00 21 00 00 00 00 00 00 00 00 00 00 00 00 00 07
04 21 00 00 00 00 00 00 22 00 20 00 00 00 00 00 00 00 21 07
04 00 00 00 00 21 00 00 00 00 21 00 00 00 00 00 00 00 00 07
04 00 00 00 00 00 00 00 00 00 00 00 00 00 00 00 00 00 00 07
04 00 00 00 00 00 00 00 00 00 00 00 00 00 00 00 00 00 00 07
04 21 00 00 00 00 00 00 00 00 21 00 00 00 00 00 00 00 21 07
01 01 01 01 01 01 01 01 01 01 01 01 01 01 01 01 01 01 01 01