01 01 01 01 06 01 01 01 07 06 07 01 01 01 01 06 01 01 01 01
02 21 00 00 00 00 00 00 00 00 20 21 00 00 00 00 00 00 21 02
04 00 22 00 00 00 00 00 00 00 00 00 00 00 00 00 00 00 00 03
07 00 00 00 00 21 00 00 00 00 00 00 00 00 00 00 00 00 00 07
06 21 00 00 00 00 00 00 22 00 20 00 00 22 00 00 00 00 21 06
07 00 00 00 00 21 00 00 00 00 21 00 00 00 00 00 00 00 00 07
07 00 00 00 00 00 00 00 00 00 00 00 00 00 00 00 00 00 00 03
06 00 00 22 00 00 00 00 00 00 00 00 00 00 00 00 22 00 00 02
07 21 00 00 00 00 00 00 00 00 21 00 00 00 00 00 00 00 21 01
01 01 01 01 06 01 01 01 07 06 07 01 01 01 01 06 01 01 01 01