01 01 01 01 01 01 01 01 01 01 01 01 01 01 01 01 01 01 01 01
02 21 00 00 00 00 00 00 00 00 20 21 00 00 00 00 00 00 21 02
04 00 22 00 00 00 00 00 00 00 00 00 00 00 00 00 00 00 00 03
03 00 00 00 00 21 00 00 00 00 00 00 00 00 00 00 00 00 00 04
04 21 00 00 00 00 00 00 22 00 20 00 00 22 00 00 00 00 21 05
05 00 00 00 00 21 00 00 00 00 21 00 00 00 00 00 00 00 00 04
04 00 00 00 00 00 00 00 00 00 00 00 00 00 00 00 00 00 00 03
06 00 00 22 00 00 00 00 00 00 00 00 00 00 00 00 22 00 00 02
04 21 00 00 00 00 00 00 00 00 21 00 00 00 00 00 00 00 21 01
01 01 01 01 01 01 01 01 01 01 01 01 01 01 01 01 01 01 01 01