16 16 16 16 16 16 16 16 16 16 16 16 16 16 16 16 16 16 16 16 16 16 16 16 16 16 16 16 16 16
15 00 00 00 00 00 00 16 00 16 00 00 00 00 16 00 20 00 20 00 16 00 20 00 18 00 00 00 00 15
17 00 20 00 00 00 00 16 00 15 16 16 00 20 16 00 15 16 16 00 16 00 16 00 15 22 00 00 00 17
15 00 00 00 00 00 00 15 20 00 00 16 17 00 16 00 16 00 20 00 16 00 16 20 16 22 00 00 00 15
18 00 00 00 00 00 00 16 00 16 00 17 00 00 18 00 15 00 16 18 17 20 16 00 15 15 15 00 00 18
15 00 18 16 00 00 00 16 00 17 20 16 00 00 16 20 16 00 16 00 00 00 18 00 20 00 20 00 00 15
17 00 20 16 00 00 00 18 20 16 00 17 16 00 16 20 18 20 16 00 20 00 17 20 16 15 15 00 00 17
15 22 00 16 00 00 00 20 00 16 00 00 00 00 20 20 16 00 00 00 00 22 16 22 15 00 00 00 00 15
16 16 16 16 16 16 16 16 16 16 16 16 16 16 16 16 16 16 16 16 16 16 16 16 16 16 16 16 16 16