01 01 01 01 01 01 01 01 01 01 01 01 01 01 01 01 01 01 01 01
02 00 00 00 00 00 00 00 00 00 00 00 00 00 00 00 00 00 00 02
04 00 22 00 00 00 00 00 00 00 00 00 00 00 00 00 00 00 00 03
03 00 00 00 00 00 00 00 00 00 00 00 00 00 00 00 00 00 00 04
04 00 00 00 00 00 00 00 22 00 00 00 00 22 00 00 00 00 00 05
05 00 00 00 00 00 00 00 00 00 00 00 00 00 00 00 00 00 00 04
04 00 00 00 00 00 00 00 00 00 00 00 00 00 00 00 00 00 00 03
06 00 00 22 00 00 00 00 00 00 00 00 00 00 00 00 22 00 00 02
04 00 00 00 00 00 00 00 00 00 00 00 00 00 00 00 00 00 00 01
01 01 01 01 01 01 01 01 01 01 01 01 01 01 01 01 01 01 01 01